1d
1f
0f
0a
3030303030303030303030303030303030303030303030303030303030303030
30304a30304a30304a30304a30304a30304948304a30304a30304a30304a3030
3030303030303030303030303030303030453030303030303030303030303038
3030303030303030303030303030c04cc1303030303030303030303030303038
38303030303030303030303030304d4b4e303030303030303030303030383838
3830303030303030303030303030303030303130303031313030303038383838
3838313030303130303030303030303030303030303131313130303038383138
3838303030303030303030303030303030303030313131313131303838383838
3838303030303131303030303030313030303030303131313131313838383838
3838303031313131313130303030303030303030303131313131313138383838
3838383131313131313131303030303130303030303131303131313130383838
3838383131313130313131303131313030303030313131313131313138383838
3838303131313130303131303131303030303030313131303031313038383838
3838303131313030303131303130303030303030303131313130313038383838
3830303031313131303031303130303030303030303131303131303030383838
3830303031313131303131303031303030303030303031313131303030303838
3030303030313131303131303031303030303030303131313130303030303838
3030303030303030303030303030303030313030303031313130303030303138
3030303030303030303030303030303031303030303031313131303030303038
3030303030303030303030303030313030303030303030313131303030303038
3030313030303030303030303030303030303030303030313130303030303031
3030303030303030313030303030303031303030303030313131303130303030
3030303130303030313030303030303030303030303030303131303030303030
3030303030303030303030303030303030303030303031303130303030313030
3030303030303030303030303030303030303030303031313130303030303030
3030303030303030303030303030303030303030303030303130303030303030
3030303030303031303030303030303030303030303030313030303030303067
6830303030303030303030313030304530303030303030303030303030306760
6068303030303030303130303030303030303030303030303030303067616060
6060616830303030303030303030303030303030303030303030676160606060
