1d
1f
00
10
303b3b3b3b3b3b3b3b3b3b3b3b3b3b3b3b3b3b3b3b3b3b3b3b3b323232323232
3b3b30303030303031313230323132313232303b3b3b3b3b3b32323132323232
3b30c04cc130303030303131313031303131313b3b3b30313131313131453231
3b304d4b4e30303030303b3b3b3b3b3b3b3bb93b6b6c31303130303030313232
3b3030303030303030303b3b3b3b3b3b3b3bb93b6a6b6b6b6c30303030303232
3b3b3030303030303b3b3b303030303030303030306a6a6a6c6c303030303232
303b3bb93b3b3b3b3b3030306c6e6c6e6b6b6c30303030326c6caa3030303132
30303030303030303030306c6ea26ba2a0a06caab9a330316c6ea33030303031
303030303030303030306c6ea2a0a0a0a0a06b9e3d9f6c6c6e6da33030303030
3030303130303030306c6ea2b2a0a0a0b2a0a0a0a0a06c6c6da3303030303030
3030303031303030306ca2a0a0a06cb5a0a0a0a06c6e6b6c6c30303030303030
3230313030303030306c6c9eb59f6b6c6e9e3d9f6cabab6b6c6c303030303030
3232463046303030306b6ca2b2b2a06ca2a0a0a06ca2a0a06c6caa3030303030
3132484549313030306a6b6cb5b2b26ca2a0a0a06ca2a0a06b6c6c3030303030
303130303030303030306a6b6cb5a06b6cb56c6e6ba2a0a0a06c6caa30303030
303030304a3030303031316a6ca2a0a06b6c6ea2a0a0a0a0a06c6ea330303030
6830303030303030303030306b6cb5a0a06ba2a0a0a0a0a0a06c6da330303030
6430303030303130303030306a6ca2a0a0a0a0a0a0a0a0a06c6ea34a30303030
643030313030303030313030306ca2a0a0a0a0a06cb5a06c6e6da33030303030
643030303030303030303030306ca2b2a0a0a0a06ca26c6c6da3303030303030
606830303030313030303030306ca2a0a0a06c6e9ea29f6ca330303030303030
606068303030303130303030306b6cb5b2a06c6dbdb9be6b6b30303030303030
606064303030303030303130306a6b6b6b6b6ba330b9a36a6aaa303030303030
60606068303030303030303030306a6a6a6a6aa3303030303030313030303030
6060606068676830303130303030303030303030303030303030303130303030
6060606060606068303030303130303030303030303030303030303030303032
6060606060606066303030303030313030303030303030303030303030303032
6060606060606068303030303030303030303030303030303030303030323231
6060606060606060683030303030303030303030303030303030303032313232
6060606060606060606161683030303030303030303030303030323232323232
