16
1f
08
06
3030303030303030303030303030303030303030303030303030303030303030
30302e6e6b6b6b6b6b6c6e6b6b6b6b6b6b6b6c6e6b6b6b6b6b6b6b6b6b2f3030
30306ca2a0a0a0a0a06ba2a0a0a0a0a0a0ab6c6d6a6a6a6a6a6a6a6a6a6caa30
30306ca2a0a0a0a0a0a0a0a0a0a0a0a0a0a06ca33030303030313030306b6b6b
30306ca2a0a06c6e6b6cb5a0a0a06c6e9eb59fa330a0a0a0a0a03131306a6a6a
30306ca2a0a06ba2ab6ca2a0a0a06c6dbdb9bea3a0a0a0a0a0a0a0a030303030
2e6e6ba2a0a0a0a0a06ca2a0a0a06b6c30b9a33030a0a0a0a0a0a031306c6e6b
6ca2a0a0a0a0a0a0a06ca2a0a0a0a06caa3131313030303030303030306c6d6a
6ca2a0a0a0a0a0a0a06b6b9eb59f6b6b6b6b6b6b6b6b6c6e6b6b6b6b6b6b6b2f
6ca2a0a0a0a0a0a0a0a0abb5a0a0a0a0a0a0a0a0a0ab6ca2a0a0a0a0a0a0a06c
6ca2a06cb56cb5a0a0a0a0a0a0a0a0a0a0a0a0a0a0a06ca2a0a0a0a0a0a0a06c
6ca2a06ca26ca2a06c6c6c6c6c6c6c6cb5a0a0a0a0a06ca2a0a0a0a0a0a0a06c
6ca2a06cab6ca2a06c6cb0b0b0b0b06c6cb5a0a0a0a06ca2a0a0a0a0a0a0a06c
6ca2a06ca26ca2a06c6ca2b2aeb3b46c6ca2a0b2b2a06b6b9e3d9f6b6b6c6e4f
6ca2a06ba26ba2a06c6ca2a0a0a0a06c6ca2a0a0a0a0a0a0a0a0a0a0a06c6d5f
6ca2a0a0a0a0a0a06c6ca2a0a0a0a06c6ca2a0a0a0a0a0a0a0a0a0a0a06ca330
6ca2a0a0a0a0a0a06c6ca2a0a0a0a06c6ca2a0a0a0a0a0a0a0a0a0a0a06ca330
6ca2a0b0b4b0b4a06b6ba2a0a0a0a06c6e6b6b6b6b9eb4a09f6b6b6b6b4fa330
6ca2a0a0a0a0a0a0a0a0a0a0a0a0a06c6d6a6a6a6abd7071be6a6a6a6a5fba30
6ca2a0a0a0a0a0a0a0a0a0a0a0a0a06ca330303030307071a330303030303030
696b6b6b6b6b6b6b6b6b6b6b6b6b6b4fa3454830303030303030313130313030
5c6a6a6a6a6a6a6a6a6a6a6a6a6a6a5fba303031303030303031303031303030
3030303030303030303030303030303030303030303030303030303030303030
