18
1f
00
10
3232323232323232323231323232313232323232323232323232575830303030
3232323232323232313232323232323232323232323232323232575830303030
3232323131313131313131313131313131313131313131313131575830303030
3232323b3b3b3b3b3b3b3b3b3b3b3b3b3b3b3b3b3b3b3b3b3b3b575830303030
3232323ba0a0a0a0a0a0a0a0a0a0a0a0a0a0a0a0a0a0a0a0a03a3a3a30303030
3232323ba0a0a0a0a0a0a0a0a0a0a0a0a0a0a0a0a0a0a0a0a03a3a3a30303030
3232323ba0a0a03b3b3b3b3b3b3b3b3b3b3b3b3b3b3b3b3b3b3b575830303030
3232323ba0a03b3b3232323132a0313132323231313132323232575830303030
3131313ba0a03b31323232323246a04a323232b6a6b732323132575830303030
3b3b3b3ba0a03b3b3131313131313131313131a7a5a831313131575830303030
a0a032a0a0a0323b3b3b3b3b3b3b3b3b3b3b3b3b3b3b3b3b3b3b575830303030
a0a0a0c04cc1a0a0a0a0a0a0a0a0a0a0a0a0a0a0a0a0a0a0a03a3a3a30303030
a0a0a04d4b4ea0a0a0a0a0a0a0a0a0a0a0a0a0a0a0a0a0a0a03b575830304530
a0a0a0303030a0a0a0a0a0a0a0a0a0a0a0a0a0a0a0a0a0a0a03a3a3a30303030
a0a032a0a0a0323b3b3b3b3b3b3b3b3b3b3b3b3b3b3b3b3b3b3b575830303030
3b3b3b3ba0a03b3b313232323231313132323232323232323232575830303030
3232323ba0a03b31323232323246a04832323232323132323232575830303030
3232323ba0a03b3b3131313131a0313131313131313131313131575830303030
3232323ba0a0a03b3b3b3b3b3b3b3b3b3b3b3b3b3b3b3b3b3b3b575830303030
3232323ba0a0a0a0a0a0a0a0a0a0a0a0a0a0a0a0a0a0a0a0a03a3a3a30303030
3232323ba0a0a0a0a0a0a0a0a0a0a0a0a0a0a0a0a0a0a0a0a03a3a3a30303030
3232323b3b3b3b3b3b3b3b3b3b3b3b3b3b3b3b3b3b3b3b3b3b3b575830303030
3232323232323232323232313232323232323232323232313232575830303030
3232323232323232323231323232323232323232323232323232575830303030
3232323232323232323232323232323232323232323232323232575830303030
