1d
1f
0f
10
5b5b5b5b5b5b5b5b5b5b5b5b5b5b5b38303030303030385b5b5b5b5b5b5b5b5b
5b5b5b5b5b5b5b5b5b383838383838303030303030303038385b5b5b5b5b5b5b
5b5b5b5b5b5b5b5b5b38383838303030303030303030303838b6a6b75b385b5b
5b5b5b3838385b383838383838383030303030303030303038a7a5a838385b5b
5b5b5b5b3838383838a038383838303030303030303030303038303838385b5b
5b5b5b5b5b3838384848a0a038303030303030303030303030383038385b5b5b
5b5b5b5b5b383838454949a03030303b3b70713b3b30303130383038385b5b5b
5b5b38385b38a0a0a0a0a0a0303b3b3b3b70713b3b3b30303131303038385b5b
5b5b38383838383838b3b43b3b3b3b3b3b70713b3b3b3b3b3b30313030383838
5b5b3838383830303030303b3b3b6c6c6c70716c6c6c6c6c3b3b303030303838
5b5b38383830303b3b3b3b3b3b6c6c6f6aa3306a6a6a6a6c6c3b3b3031303838
38383838303030303b3b3b6c6c6c6fa3303030303030306a6ca23b3b30303138
38383838383830303b3ba06c6f6aa33030313030313030306ca23b3b31303138
383830303030303b3b3ba06ca330304a4a4a53544a4a4a306ca23b3b31303130
383030303b3b3b3b3b3ba06c6c6c3030303155563130306c6ca23b3b30303030
38383030303030303b3ba06a6a6c6c30303030c04cc1306c6fa23b3b30303038
3838383030304a30303b6aa0a06a6c6c6c30304d4b4e306ca2a03b3b30303038
3838383838383030303b3b6a6aa06a6a6c6c6c3030306c6ca26a3b3030313038
383838383838303030303b3b3b6aa0a06a6a6c6c6c6c6c6fa23b3b3031303138
385b5b38383830303130303b3b3b6a6aa0a06a6a6a6a6aa2a03b303030303838
5b5b5b383838383131313030303b3b3b6a6aa0a0a0a0a06a6a3b303031303838
5b5b383838383831303030303030303b3b3b6a6a6a6a6a3b3b3b303030383838
5b5b385b5b5b38383838303030303030303b3b3b3b3b3b3b3030303838385b5b
5b38385b5b5b3838383838383030303030303030303030303030303038385b5b
5b385b5b5b5b3838385b3838303031303030303030303030303030303030385b
5b5b5b5b5b3838385b5b5b5b383830313030303030303030303030304645385b
5b5b5b5b5b38385b5b5b5b38383838303030303030303030303030303030385b
5b5b5b5b5b385b5b5b5b3838385b38303030303030303030303030303030385b
5b5b5b5b5b5b5b5b5b3838385b5b5b3838303030303030303030303030303038
5b5b5b5b5b5b5b5b5b5b5b5b5b5b383838383830303030303030303030303030
