1d
1f
00
00
3131313131313131313030303030303030303030303030313131313131313131
3131a0a0a0463131303030303030303030303030303030303031313131313131
3131a04849a03030303030303030303030313131303030303030303131313131
3131a0a045a03030303030303030303131383838313030303030303030313131
3131313131313130303030313131313131383838383131303130303030303131
3131313030303030303031313131313138383838383131313130303030303131
3131313030303030303031313131383838383838383131313131303030303031
313838383830303030313131313838385b5b3838383831313030303030313131
38383838383838383838383838385b5b5b5b5b5b383838313130303030303131
383838383838385b5b385b5b5b5b5b5b5b5b5b5b383831313130303030303131
38385b5b5b5b5b5b38383838383838385b5b5b38383831313030313030303030
385b4a4c4a5b3838383830303131383838383838383131313030303130303130
385b4d4b4e303030303030303030313838383838313131303030313031303030
385b4a304a5b3838303030303131303031313131313130313030313030313030
38385b5b5b383838303030313030313030313030303030303030303031303031
3838383838383838303031313031303030303031303131303031303131303131
3838383838383830313131313131383131303130303130313030303130313131
3138383838303030303031313838383838383830313130313030303031303131
313131303031303031313138383838383838383830314a303130313030303031
31313131303030313031383838b0b0b0b0b03838383130303030303030303130
313131313130313030383838b0b0b4aba0b0b038383831303030303030303130
3131313131313030313838b0b0b4a03cb4a0b0b0383831313130303030303030
313831313130303030383838b0b0b4a0a0b0b038383831313030304a30303131
38383138313130303038383838b0b4a0a0b03838383831303030303031303131
38383831313131303030383838b0b0a0b0b03838383131313031303130303131
383838383138383130314a383838b0b9b0383838313130313130303031313131
3838383838383131313130303031b0b9b0313131303031304a30303131313131
3838383838383131313131313130303030313030313130303030303130313031
3830383838383138313131313130303030303130313030303130313131313130
3838383838383838313131313031303130313031303031303031313031313031
