1d
0f
0f
00
b0b0b0b4a0b0b0b0b0b0b0b4a0b0b0b0
a0a0a0a0a0a0b2b2aeb2b2a0a0a0a0a0
b0b4a0a0a0a0a0a0a0a0a0a0a0a0a0b0
b0b4a0a0a0a0a0a0a0a0a0a0a0a0a0b0
b0b4b0b0b0b0b0b0b0b0b0b0b0b0b4b0
b0b4b0b4a0b2a0abacb5b3b4a0b0b4b0
b0b4b03db0b0b0b0b0b0b0b03db0b4b0
a0a0a0a0a0a0a0a0a0a0a0a0a0a0a0a0
b0b0b0b0b0b0b0b4a0b0b0b0b0b0b0b0
b0b4aba0aba0b0b4a0b0b4a0a0a0a0b0
b0b0b03db0b0b0b4a0b0b0b03db0b0b0
a0a0a0a0a0a0a0a0a0a0a0a0a0a0a0a0
b0b0b0b0b0b0b0b4a0b0b0b0b0b0b0b0
b0b4a0a0a0a0b0b4a0b0b4abb5abb5b0
b0b0b03db0b0b0b4a0b0b0b03db0b0b0
a0a0a0a0a0a0a0a0a0a0a0a0a0a0a0a0
b0b0b0b0b0b0b0b4a0b0b0b0b0b0b0b0
b0b4abb5abb5b0b4a0b0b4a0a0a0a0b0
b0b0b03db0b0b0b4a0b0b0b03db0b0b0
a0a0a0a0a0a0a0a0a0a0a0a0a0a0a0a0
b0b0b0b0b0b0b0b4a0b0b0b0b0b0b0b0
b0b4a0a0a0a0b0b4a0b0b4aba0aba0b0
b0b0b03db0b0b0b4a0b0b0b03db0b0b0
a0a0a0a0a0a0a0a0a0a0a0a0a0a0a0a0
a0a0a0a0a0a0b3b4a0b2a0a0a0a0a0a0
a0b0b4a0a0a0a0a0a0a0a0a0a0a0b0b4
71b070a1a1a1a1a1a1a1a1a1a1a1b070
b0b0b0aa303030303030303030b0b0b0
30b0aa30a0a0a045a0a0a0a03030b0aa
303030a0a0a0a0a0a0a0a0a0a0303030
