15
1f
07
03
5b5b5b5b5b5b5b5b5b5b5b5b5b5b5b5b5b5b5b5b5b5b515b5b5b5b5b5b5b5b5b
5b304a30305b5b5b5b5b5b5b5b5b304a305b5b5b5352565b5b5b5b5b5b5b5b5b
5b30305b315b5b5b5b303132305b30305b5b465358b6a6b75b5b5b31305b5b5b
5b5b5b3130305b5b303030315b30305b5b45305758a7a5a85b5b5b4631315b5b
5b5b303030303030303030305b305b5b4830305758303030315b30303030305b
5b30303030535430313031305b30305b3030303a3a303030305b303030305b5b
5b303030305556c04c4cc13030305b303030535056303030303030303032315b
5b3030303030304d4b4b4e30315b30303053505630313030303030313032305b
5b30303030303030303030305b5b303053505630303030313031303030313130
303030304a30303030305b305b3030303a3a3030303030303031303030303030
3030303030303030303030303030303057583030303030303131303130303230
3030303030303030303030303030303057583030303030303030303046303130
5b30303030303030303030303031303157583030313030303030303030303031
5b5b3030303032303030305b3130323057583030303030303030303030303030
5b5b5b30303031303030305b5b30315b57505952523952525239525252395252
5b5b5b5b30315b305b5b5b5b30315b5b57505830303030303030303030303030
305b5b5b4a5b5b5b5b5b3130305b5b5b575a5630303030303030303030303030
30305b5b305b5b3030313031305b5b5356303030313030303030303030303030
30303032315b303030303130305b5b513031303030314a303030303030303030
303031323030303030303030305b5b5130303130303030303030303030303030
3030303231303130303030303030305130303030303232323231303030303030
3030313131313030303030303030305130303030313131313130303030313030
