15
1f
07
0e
3030303030303030303030303051323032513030303030303030303030303030
3030303031313230303030303051323032513030303030303031303030303030
3030c04cc1303232303030303051323032513030313030303030303030303030
30304d4b4e313131313030303051324632513030303030313131303030303030
3030303030303030303030313151313032513030313232303030303030303130
303030303030303030303030303a304732513030303131324a32303030303030
3030303030303030303030313151323032513030535954313131313030313030
30303030303030303030b6a6b751323032513030575050595959595954303130
30303030303030303030a7a5a851313031513030575050505050505058303030
3031323030303030303030303057525252503939505050505050505058303232
3030313130303130303030303051323032573939505050505050505058303132
3030303030303030303030303051313031513030575050505050505058303031
3030303130313030303032303057525252563030555a5a5a5a5a5a5a56303030
3030303030303030303031303051463030303030303030304630313030303030
5252525239525252525252525256313030303030313030303030303030303030
3030303030303030303030303031303030303030303030303030303030303030
30303030b6a6b7304a30303030303030303130313030304a3030303030303030
30303030a7a5a830303030303030303030303030303030303030303030303030
3030303030303031303030303046303030303030303130303030303030303032
3030303030303030303030303030303048454630303030313031303030303032
3030303030303030303030303030303030303030303030303030303030303031
3030303030303031303130303030303030303030303030303130303030303030
