1d
1f
0f
00
5b5b5b5b5b5b5b5b5b5b5b5b5b5b5b5b5b5b5b5b5b5b5b5b5b5b636060606060
5b5b5b5b5b5b5b5b5b5b5b5b304a4a305b5b5b5b5b5b5b5b5b67606060606060
5b304a4a4a5b5b5b5b5b5b3030303030305b5b5b5b5b5b5b6760606060606060
5b30303030305b305b5b30303030303030305b5b5b5b5b676060606060606060
5b30303030303030305b30303030303030305b5b5b5b67606060606060606060
5b3030303030303030305b30303030303030305b5b5b63606060606060606060
5b5b30303030303030305b5b3030303030305b5b5b6760606060606060606060
5b5b5b30303030303030305b5b303030305b6761616060606060626260606060
5b5b5b5b5b305b3030305b5b5b383030305b6360606060606066303065666560
5b5b5b5b5b5b5b5b30303038383830305b676060606060606630304530306760
5b5b5b463046385b38303030303030305b656260606060663030303030306566
5b5b3030313030383830303030303030305b5b636060663030c04cc130313030
5b3030303030303130303030303030303030303a3a3a3030304d4b4e30303030
303030313130303030303838385b5b5b5b306760606430303030303030313130
3030313030303030383838385b5b5b5b67616060606068303030313031303030
303030313030303038385b5b5b5b5b6760606060606060616168303030303030
5b313030303030385b5b5b5b5b5b676060606060606060606060683030303030
5b30303130305b5b5b5b5b5b5b67606060606060606060606060606168306768
5b5b303030305b5b5b5b5b5b6760606060606060606060606060606060616060
5b5b5b5b3030305b5b5b5b5b6360606060606060606060606060606060606060
5b5b5b5b5b303030305b5b5b6360606060606060606060606060606060606060
5b5b5b5b5b30303030305b5b6560606060626060606060606060606060606060
5b5b5b5b5b30303030385b5b5b65606060686560606060606060606060606060
5b5b5b5b5b30303038383030305b656665663165606060606060606060606060
5b5b5b5b5b5b30303030303131b2a0a045a0a031656060606060606060606060
5b5b5b5b5b5b5b30303030a0a0a0a0494848a0a0316560606060606060606060
5b5b5b5b5b5b5b303030303131b2a0494748a0a0a03265606060606060606060
5b5b5b5b5b5b5b5b5b5b5b30305b30a0a0a0a0a0a03167606060606060606060
5b5b5b5b5b5b5b5b5b5b5b5b5b5b5b5b5b676831316760606060606060606060
5b5b5b5b5b5b5b5b5b5b5b5b5b5b5b5b67606061616060606060606060606060
