0e
1f
00
10
6060606060606060606060606060606060606060606060606060606060606060
6060606060626262606060606060606060606060606060606060626060606060
6060606066303030656060606060606060606060626262626266316562606060
60606066303030315b6560606060606062626266464646303031483130656060
60606630c04cc1305b5b6560606060664a303030303030303030b6a6b7306360
606430304d4b4e305b5b5b656262663030303030313030303030a7a5a8306360
60643030303030315b5b5b5b5b5b303030303030306761683030303030306360
6064303030303030315b5b5b313030303130303067606266304a303030306360
606430b6a6b73030303838313030303030306761606630303030303030676060
606430a7a5a8303038303030303030303131636066b6adb73030303067606060
6060683030303030304a3030303030313167606431a7a9a83031306760606060
6060606830303030303030303230306761606060683030313030306360606060
6060606068304646676161683030676060606060606161616831316360606060
6060606060616161606060606161606060606060606060606061616060606060
6060606060606060606060606060606060606060606060606060606060606060
