1d
1f
04
10
3838383838636066383031303131313030303130313031636630303030303030
3838676867606438383130313031313131313130313030656830306768303030
3867606060626638383030303032313032313132303230306568676665616161
6760606066383838303030323232303131303130323030303065664530636062
60606066383838c04cc130313031313031303030323030303030314947636430
606064383838324d4b4e31303131313131303132303032303030304848636630
60606438383232303032303138383838383838314a3230303030303067643030
6560643838383032323232383838383838383838383130303030306760663030
3865643838323232323238383838383838383853543831313030306364303030
383863683832323231383838384a4a4a4a383855583831303030536266303030
38303a3a4a323232383838383030303030303838513838313030513030303030
3830636438313138383838323030303030303838513830303030514530303030
3030656068383838383838535430303030303038513830423030513030303030
3030306364383838383838555630303030303038555252405252563030303030
3030306364383838383030303030303030303030303032303030303030303030
3030303a3a303130303030303030303030303030303032323030303030303030
3030306564323030323030303030303032303030303232323030303030303030
304a306766303030323232b6a6b7323032323232323232303030303030303030
304a676630304a30303031a7a5a8303030303030303030303030303030303030
3067643030303030323230303030303030303030303030303030303030303030
3063643232303032303030303030303030303032323030303030303030303067
6863643030323232303030303030303030303232303030303030303030676160
646364303030303030303030303030303030303030304a303030303067606060
6060643030304a30303030303030303030303030303030303030306760606060
60606430304a30304a304a303030303030303030303030303030676060606060
6060606830303030303030303067683030303030676830303067606060606060
6060606068303030303030306760606161616161606430306760606060606060
6060606060616161616161616060606060606060606061616060606060606060
6060606060606060606060606060606060606060606060606060606060606060
6060606060606060606060606060606060606060606060606060606060606060
