1d
1f
00
10
6064303030303030303030303030303030303030303030303030303030303030
6064303030303030303030303030303030303030303030303030303030303030
6064303030303030303030303030303030303030454630303030303030303030
6060683030303030303030303030303030303030303030303030303030303030
6060606830303030303030303030304a30303030303030303030303030303030
6060606068303030303030303030303030303030303030303030303030303053
6060606060616168303030303030303030303030303030303030303030305350
6060606060606060683030303030303030303030303030303053595959595050
6060606060606060605959595959393959595959595959595950505050505050
6060606060606060606050505050393950505050505050505050505050505050
6060606060606060606050505050393950505050505050505050505050505050
6060606060606060606060505050393950505050505050505050505050505050
6060606060606060606060505050393950505050505050505050505050505a5a
6060606060606060606060605a5a39395a5a5a5a5a5a5a5a5a5a5a5a5a563030
60606060606060606060606430303030303030303030303030303030a0a0a030
606060606060606060606060543030304a30303030303030303030a048a049a0
60606060606060606060605050543030303030303030303030303045a047a0a0
606060606060606060605050505039395959595959595959543030a049a048a0
60606060606060606060505050503939505050505050505050595954a0a0a030
60606060606060606050505050503939505050505a5050505050505059543030
606060606060605050505050505039395050505630555a505050505050505430
60606060606050505a50505a5a5a39395a5a5630303030555050505050505059
60606060605a5a56305556303130303030303030313030315750505050505050
6060626266313030303030303031303031303030303030305550505050505050
60663130303030303030303030303130303130313030303031555a5a50505050
6430303030303030303031303030304a313030303030303030303131555a5a5a
6068303030313030303030303130303030303030303030303030c04cc1313031
60643030303030303030303030303030313031303031303031304d4b4e303031
6064304a4a4a4a30313030313030303030303030303030303030303030303130
6060683030303030303030303030303030303030303030313030303130303031
