1d
1f
00
10
5a5a5a5a5a5a5a5a505050505050505050563030303030305550505050505a5a
303030303030303057505050505a5a5a58303030303030303055505050563030
304a303030303030575050505846303051303030303030303030555a56303030
30304a30304a303057505050583030303a303030303030303030303030303030
3030304a4a303030575050505830303051303030303030303030303030303030
30304a30304a30305750505a5a39525258303030303030303030303030303030
3030303030304a30575058303030303051303030313030303030303030303030
3030303030303030575058303030303057543031303031303130535430303030
59595952395239525a5a5a52395259525a5a5430303130313053505830303030
505058303030b6a6b7b6a6b73030513030305552525252545350505830303030
505058303030a7a5a8a7a5a8303051303030303030303051575a5a5630303030
5050583030303030313030303030513030c04c4cc13030575830303030303030
50505054303030303030303030305130304d4b4b4e3030575830303030305359
5050505630303030303030305359583030303030303030575830303030305750
50505630303130303031303057505630303030303030305750544a5359595050
5056303030303130303030305558303030303030303030575050b95050505050
5630303130313030303030303051303030303030303053506c9e3d9f6c505050
30313030303030315352525259583030303030303053506c6ea2a0a06c505050
30303031305352525647a0a0575054303030303053506c6ea2a0a06c9e505050
303130303151a0a0a0a046a05550563030303053506c6ea2a0a0a06cbd505050
543030303051a04849454646a051304a4a305350506ca2a0a0a0a06c50505050
505430303051a0a04849a0475358303030535050506ca2a0a06c6e9e50505050
50505430305754a0a0a0a0a05758303030575050506ca2a0a06c6dbd50505050
5050583030575054b3b4b2535058303053505050509f9e3d9f9e505050505050
5050583030555a5a5239525a505059395a5a5a5050bebdb9bebd505050505050
50505830303046303030303055505630303030555a5a5ab95a50505050505050
50505054303130303030323030513030303032323230303030555a5050505050
50505a505430303132303130303a3030304a3131313030303030305750505050
5050545556303130313130313051303030313030303030303030305750505050
5050505954303030303030305350543030303030303030303030305750505050
