15
1f
00
10
5b5b30305b5b5b5b5b5b5b5b5b5b5b5b5b5b5b5b5b5b5b5b5b5b5b5b5b5b5b5b
5b5b5b30305b5b5b5b5b5b5b5b5b5b5b5b5b5b38385b5b5b5b5b5b5b5b5b5b5b
5b5b5b30305b5b5b5b5b5b5b5b5b5b5b5b5b3030303838383838385b5b5b5b5b
5b5b384548305b5b5b5b5b31303130303030314a30303030303138385b5b5b5b
5b3838303030305b303130303130315b5b5b5b3030305b5b303038385b5b5b5b
5b38383130383830305b5b5b5b5b305b5b5b3830303030385b3030385b5b5b5b
5b38323031303030385b5b5b5b5b5b5b5b38303030303030385b30385b5b5b5b
5b3831303030385b5b5b5b5b5b5b5b5b5b383830304a3030305b3030385b5b5b
5b3830c04cc131385b5b5b5b5b5b5b5b5b38383830303030325b5b3030385b5b
5b38304d4b4e3031385b5b5b5b5b5b5b5b5b5b3838313232315b5b5b30385b5b
5b38313030303030305b5b5b5b5b5b5b5b5b5b5b5b5b31315b5b5b5b30385b5b
5b3830303030303238385b5b5b5b5b5b5b5b5b5b5b5b5b5b5b5b5b5b30385b5b
5b38313030303031385b5b5b5b5b5b5bb6a6b75b5b5b5b5b5b5b5b5b30385b5b
5b383831303030385b5b5b5b5b383830a7a5a830465b5b5b5b5b5b3030305b5b
5b5b3838303030385b5b5b38463038303830303030383838383030304a305b5b
5b5b30313030305b5b3838303830303030304a3030303030303030303030305b
5b5b5b5b5b4a5b5b38303030303030303030303030303030303030303030305b
5b5b5b5b30303030303030463030303030323130303030303030303030303030
5b5b5b5b30303030303030303030303030313030305b30303030303030303030
5b5b5b5b5b5b303030303030303030303130305b5b5b5b5b3031303030303030
5b5b5b5b5b5b5b5b3030303030303030305b5b5b5b5b5b5b3030313030303030
5b5b5b5b5b5b5b5b5b5b5b5b5b5b5b5b5b5b5b5b5b5b5b5b5b30303030303030
