1d
1f
0f
00
3333333333333333333337373733333333333333333333333333333333333333
3333333333333333333548484949373333333333333333333333333737373333
3333333333373733333530303045303737333333333333333333373030303433
3333333333303037373336303030303030373737373333333737303030303433
3333333335c04cc1313437363630303030303030303433353130303030363333
33333333354d4b4e535432373336363635303030303034373030303636333337
33333333333531535058323034333333333530303030304a3030303433333530
33373733333335555a5631303433333333353030303030303036303034333736
3530303737333331313136313433333333333636363636363633353134353134
3336353030343736363633363333333333333333333333333333353030343633
3333333636353034333333333333333333333333353134373733333530343330
3333333337333530343333333333333333333333333635313037333530303436
3333333730333336333333333333333333333333333333333631343530303433
333335304a373737333337373733333333333333333333333336353036363737
3333333530303030373746303037333333333333333333333333333637373030
3333333336363530303031303030303433333333333333333333373730303030
3333333333333336363530303030303433333333333333333737303030303030
3333333333333333333530303036363333333333333333373030303030303130
3333333333333333333335303034333333333333333337303030303130303030
3333333333333333333353523952525252525254333730303130303030303030
3333333333333333333351303030303045463051373030303030303030303030
3333333333333333333351303030303030303051303030303030303031303130
333333333333333333335130303030303030303a303030313030313030303030
3333333333333333333351303031303030303051303030303053595939595959
525252525252543333335131304a31303030305153595959596c6e9eb49f6e6c
303030303030555252525a52395252525252595050505050506ca2a0a0a0ab6c
303030303030303030303030303030303030575050505050506ca2aba0a0a06c
303030303030303030303030303030303030575050505050509f6b6b6b6b6b9e
30303030303030303030303030303030305350505050505050be6a6a6a6a6abd
3030303030303030303030303030303053505050505050505050505050505050
