0e
1f
00
10
3030303030306560663130656060606060606060606066303030303030656060
3030c04cc1303051b6a6b7306360606060606060606630303030303030316360
30304d4b4e30303aa7a5a830636060606060626064303030304a313031306360
3030303031303051303030316360606262663063643032303030676161616060
3030303030313051313030676060663030303063606831306761606060606060
3031304a30303051303030656064303046303065606252396062626060606060
5b3030303030303a303030306564303030303030513030306368306360606060
5b3030303030305130303030303a3030303030303a304a306560616060606060
5b5b53525239525a395254303051303030535252563030303063606060606060
5b5b513737303737303751303051303130513030303230313063606060606060
5b5b515b3030304548303a30303a3030303a3030303131303063606060606060
5252565b5b303030303451303151303030513046303030306760606060606060
5b5b5b5b5b5b314630345552525a5252395a5430303030306360606060606060
5b5b5b5b5b5b5b5b5b3037373737373730375130303030306360626262606060
5b5b5b5b5b5b5b5b5b5b5b5b5b5b5b5b5b5b5130303030306566303030656060
