1d
1f
04
00
6060606060606060606060606060606060606060606060606060606060606060
6060606060606060606060606060606060606060606060606060606060606060
6060606060606060606060606060666560606060606060666560606060606060
6060606262626060606060606066304665626060606066313063606060606060
6060663030306560606060606630313132306360606068306760606060606060
6266303030453065606060606830303031306562606064676665606060606060
3030303030303030636060606630303030303130636060663031656060606060
3030313030303030656060663030303030303031656066b6a6b7306560606060
303030304a303030303a3a3030b0b0b031303030303a30a7a5a8303063606060
3030313030303130306364b0b4b0abb0b0b0b0b0b45130306761396160606060
3030303030313030676064b03db0b4a0a0a0abb0b46368676066306566656060
3030303030303030636064b0b4b0b0b03db0b0b0b46360606068303031676060
303030676830306760606068a0a0a0a0a03030b0b46562606064303167606060
3067616060616160606060606830a03030303030b0b0b4636066303063606060
6160606060606060626260606430a030303030b0b0b4a03a3a30306760606060
6060606060606066313063606630a0303030b0b0b4a067626061616260606060
606060606062663030303a3aa0a0a030b0b0b0b4a06766306362663065626060
606060606630303030676062683030b0b0b4a0a0676631303a30303030306360
606060663030304a306566306368b0b0b4a06761663030676068b03db0b46360
60606430303130303130323063606168304a6566303038636064b0b4b0b46560
6060643030c04cc1303031676665606630303030303838656066b0abb0b43063
60606430304d4b4e3030303a3030656830303838383030303a30b0b4b0b43063
6060663031303030303067643031306568303030303030305130b0b0b0b43063
606068303031676161616060683031303a303030676830676430303030306760
6060606830306560606262606068303063686761606261606068454867616060
6060606061616160644a31636262616160606062663065626060686760626260
606060606060606060616164303165606060664a304a313163606060644a3163
606060606060606060606060684a306360643030313030676060606064306760
6060606060606060606060606068306360606161616161606060606060616060
6060606060606060606060606060616060606060606060606060606060606060
